0 0 1 0 0 0 0 
r r 1 1 0 0 0 
r r r 2 2 0 0 
3 3 r 2 0 0 0 
3 3 r 0 0 0 0 
0 0 0 0 0 0 0 
