r r r r r r r r 0 0 0 0 0 
r r r r r r r r 0 0 0 0 0 
r 2 r r r r r r 0 0 0 0 0 
r 3 r r r r r r 0 0 0 0 0 
r 3 3 r r r r r 0 0 0 0 0 
r r r r r r r r 0 0 0 0 0 
r r r r r r r r 0 0 0 0 0 
r r r r r r r r 0 0 0 0 0 
r r r r r r r 1 1 0 0 0 0 
0 0 0 0 0 0 0 1 0 0 0 0 0 
0 0 0 0 0 0 0 0 0 0 0 0 0 
0 0 0 0 0 0 0 0 0 0 0 0 0 
