0 0 0 0 0 0 0 0 0 0 0 0 0 0 0 0 0 0 0 0 
0 0 0 0 0 0 0 0 0 0 0 0 0 0 0 0 0 0 0 0 
0 0 0 0 0 0 0 0 r r 1 1 r r r 0 0 0 0 0 
0 0 0 0 0 0 0 0 r r r r r r r 0 0 0 0 0 
0 0 0 0 0 0 0 0 r r r r r r r 0 0 0 0 0 
0 0 0 0 0 0 0 0 r r 2 r r r r 0 0 0 0 0 
0 0 0 0 0 0 0 0 r r 2 r r r r 0 0 0 0 0 
0 0 0 0 0 0 0 0 r r 2 r r r r 0 0 0 0 0 
0 0 4 4 0 0 0 0 r r r r r r r 0 0 0 0 0 
0 0 0 0 0 0 0 0 r r r r r r r 0 0 0 0 0 
0 0 0 0 0 0 0 0 r r r r r r r 0 0 0 0 0 
0 0 0 0 0 0 0 0 r r r r r r r 0 0 0 0 0 
0 0 0 0 0 0 0 0 r r r r r r r 0 0 0 0 0 
0 0 0 0 0 0 0 0 r r r 3 3 r r 0 0 0 0 0 
0 0 0 0 0 0 0 0 r r r r r r r 0 0 0 0 0 
0 0 0 0 0 0 0 0 r r r r r r r 0 0 0 0 0 
0 0 0 0 0 0 0 0 r r r r r r r 0 0 0 0 0 
0 0 0 0 0 0 0 0 r r r r r r r 0 0 0 0 0 
0 0 0 0 0 0 0 0 r r r r r r r 0 0 0 0 0 
0 0 0 0 0 0 0 0 0 0 0 0 0 0 0 0 0 0 0 0 
