0 0 0 0 0 0 0 0 0 0 0 0 0 0 0 0 0 0 0 
0 0 0 2 0 r r 1 1 1 r r r r r r r 0 0 
0 0 0 0 0 r r r r r r r r r r r r 0 0 
0 0 0 0 0 r r r r r r r r r r r r 0 0 
0 0 0 0 0 r r r r r r r r r r r r 0 0 
0 0 0 0 0 r r r r r r r r r r r r 0 0 
0 0 0 0 0 0 0 0 0 0 0 0 0 0 0 0 0 0 0 
0 0 0 0 0 0 0 0 0 0 0 0 0 0 0 0 0 0 0 
