0 1 0 0 0 
0 0 0 0 0 
0 0 0 0 0 
0 r r r 0 
0 r r r 0 
0 r r r 0 
0 0 0 0 0 
0 0 0 0 0 
0 0 0 0 0 
0 0 0 0 0 
0 0 0 0 0 
